Go! - Public Serivce Broadcasting
Rocket Man - Elton John
Don't Go Breaking My Heart - Elton John
Your Song - Elton John
Free Bird - Lynyrd Skynyrd
Mary On A Cross - Ghost
Square Hammer - Ghost
Never Fade Away - Samurai 
Resist and Disorder - Rezodrone
Chippin' In - Damian Ukeje
Black Dog - Samurai
The Rebel Path - P.T. Adamczyk
Rules of Engagement - Geneburn
At Doom's Gate - Mick Gordon
Good L_ck - Celldweller
Take Control - Old Gods of Asgard
Violence - Le Dstroy
V - Marin Pryzbyto
Superhot - Zardonic
- DJ Goddessqueen -
GIRL HELL 1999 - femtanyl
U Should Not Be Doing That - Amyl and Then Sniffers
pressence - shxrda
CUNTISSIMO - MARINA
Bimbo Doll - dreamsoda
Wires And The Concept Of Breathing - A Skylit Drive
Soyokaze - imase
Beautiful Princess Disorder - milkypossum
New Perspective - Panic! At The Disco
Pretty Girl Vamp - Xtick Man, ODECORE
NO STRINGS ATTACHED - ZOMB
Pain - PinkPatheress
Misery in Waking Hours - $uicideboy$
Funky Galileo - Sure Sure
Quarter Pounder - Gezebelle Gaburgably
Cuntology 101 - Lambrini Girls
Make U Cum - Ayesha Erotica
Hellrap - Ghostemane
Masturbating in a Coffin - Elita
DISCIPLE OF MISERY - 99zed, TWENTYTHREE, Saliva Grey
Discord - The Living Tombstone, Eurobeat Brony
- Chris Chrispie Interview - 
Love Takes Miles - Cameron Winter
Colorado - Greg Freeman
Resident Evil - Friendship
Chrome Drumset - Oldstar
Tastes Just Like It Costs - MJ Lenderman
American - Frog
Harnessed in Slums - Archers of Loaf
Masterpiece - Big Thief
Old to Begin - Pavement
- DJ Big Bratty - 
Come and Get Your Love - Redbone
Hooked On A Feeling  - Blue Swede
Theia - Extended - King Gizzard and The Lizzards
https://open.spotify.com/track/4iRg9tHDgmRPvv56IC46Pl?si=daf5e06693824690
https://open.spotify.com/track/5d7O0hwpi92wfOdXIs9P1h?si=7126239de6cf4464
Are We Living In Those Days - North Korean Archives
Reunification Rainbow - North Korean Archives
Tai Pilseta - Raimonds Pauls
Fortunate Son - Creedence Clearwater Revival
Sympathy For The Devil - The Rolling Stones
Pigs - Pink Floyd